6,4,4,2,3,9,1,9,1,9,1,3,2,6,7,2,8,9
9,8,7,8,1,2,3,4,5,1,4,3,6,1,7,2,2,3
2,6,5,4,9,7,4,5,3,3,2,1,8,1,6,3,1,1
2,3,9,7,3,3,1,4,8,3,8,3,4,7,4,6,9,4
9,5,3,1,7,5,9,1,5,7,8,6,2,8,6,9,4,6
2,5,6,3,7,3,7,2,6,4,3,9,3,5,5,3,4,4
9,3,4,5,3,6,9,9,7,5,9,6,4,5,9,7,5,6
1,3,3,3,5,4,1,9,1,2,6,3,1,5,1,6,1,5
6,3,1,3,3,2,7,9,7,8,8,4,8,7,1,8,2,8
